0 0 0 0 0 0 0 0 0 0 0 0 0 1 0 0 0 0 0 0 0 0 0 0 0 0 0 0 0 0
0 0 0 0 0 0 0 0 0 0 0 0 0 1 0 0 0 0 0 0 0 0 0 0 0 0 0 0 0 0
0 0 0 0 0 0 0 0 0 0 0 0 0 1 0 0 0 0 0 0 0 0 0 0 3 0 0 0 0 0
0 0 0 0 3 0 0 0 0 0 0 0 0 1 0 0 0 0 0 0 0 0 0 0 3 0 0 0 0 0
0 0 0 0 3 0 5 0 0 4 0 0 0 1 0 0 0 0 0 4 0 0 5 0 3 0 0 0 0 0
0 0 0 0 3 3 3 3 3 3 3 3 3 2 3 3 3 3 3 3 3 3 3 3 3 0 0 0 0 0
0 0 0 0 3 0 0 0 0 0 0 0 0 1 0 0 0 0 0 0 0 0 0 0 3 0 0 0 0 0
0 0 0 4 3 5 0 0 0 0 0 0 0 1 0 0 0 0 0 0 0 0 0 5 3 4 0 0 0 0
0 0 0 0 3 0 0 0 0 0 0 0 0 1 0 0 0 0 0 0 0 0 0 0 3 0 0 0 0 0
0 0 0 0 3 0 0 0 0 0 0 0 0 0 1 0 0 0 0 0 0 0 0 0 3 0 0 0 0 0
0 0 0 0 3 0 0 0 0 0 0 0 0 0 1 0 0 0 0 0 0 0 0 0 3 0 0 0 0 0
0 0 0 4 3 5 0 0 0 0 0 0 0 0 1 0 0 0 0 0 0 0 0 5 3 4 0 0 0 0
0 0 0 0 3 0 0 0 0 0 0 0 0 0 1 0 0 0 0 0 0 0 0 0 3 0 0 0 0 0
0 0 0 0 3 3 3 3 3 3 3 3 3 3 2 3 3 3 3 3 3 3 3 3 3 0 0 0 0 0
0 0 0 0 3 0 5 0 0 4 0 0 0 0 1 0 0 0 0 4 0 0 5 0 3 0 0 0 0 0
0 0 0 0 3 0 0 0 0 0 0 0 0 0 1 0 0 0 0 0 0 0 0 0 3 0 0 0 0 0
0 0 0 0 3 0 0 0 0 0 0 0 0 0 1 0 0 0 0 0 0 0 0 0 3 0 0 0 0 0
0 0 0 0 0 0 0 0 0 0 0 0 0 0 1 0 0 0 0 0 0 0 0 0 0 0 0 0 0 0
0 0 0 0 0 0 0 0 0 0 0 0 0 0 0 1 0 0 0 0 0 0 0 0 0 0 0 0 0 0
0 0 0 0 0 0 0 0 0 0 0 0 0 0 0 1 0 0 0 0 0 0 0 0 0 0 0 0 0 0